B B B B B B B B B B B B B B B B B B B B B B B B B B B B B B 
B f f f f f f f f f f f f f f f f f f f f f f f f f f f f B 
B f f f f f f f f f f f f f f f f f f f f f f f f f f f f B 
B U U U U U U U U U f U U U U f U U U U f U U U f U U U U B 
B U U U U U U U U U U U f U U U U U U U f U U U U U U U U B 
B U U U U U U U f U U U U U U U f f U U U U U U U f U U U B 
B U U U U U U U U U U U U U U U f U f U U U U U f U U U U B 
B U U U U U U U U f U U U U U U U U U U U U U U U U f f f B 
B U U U U U U U U f f f U f U U U f U U U U U f U U U U U B 
B U U U U U U U U U U U U U U U U U U U U f U U U U U U U B 
B U U U U U U U f U U U U f U U U U U U U U U U U U U U U B 
B U U U U U U U U U U U U U f U f U U U U U U U f U f U U B 
B U f U U U U U U U U f f U U U f U U U U f U U U U U U U B 
B U U U f U U U U U U U U U U f U U U U U U f U U U U U U B 
B U U U U U U U U f f U U U U U U f U U f U f U U U U U U B 
B U f U U U U U U U U f U U f U U U U U U U U U f U U f f B 
B U f U f U U U U U U U U U U f f U U U U f U U U U f U U B 
B U U U U U U f U U U U U U U U U U U U f U U U U U U U U B 
B U U U f U f U U U U U U U U f U U U U U f U U U U U U U B 
B B B B B B B B B B B B B B B B B B B B B B B B B B B B B B 
