B B B B B B B B B B B B B B B B B B B B B B B B B B B B B B 
B f f f f f f f f f f f f f f f f f f f f f f f f f f f f B 
B f f f f f f f f f f f f f f f f f f f f f f f f f f f f B 
B T C X T U C G T T f U U G U f X G S U f X G X f T S C C B 
B U U U X T S C T G C G f C U C G U G X f U C X U X G S U B 
B S C X X S X T f C C X S C T S f f X T S T U T G f G U C B 
B T S X S G X S G T U U X U U X f C f S U T U S f S T T S B 
B C C T T T S C C f T X X G S C C G T X T C X C C T f f f B 
B S S G T T G G G f f f G f G T C f U S X U U f G U X X C B 
B G G C U G G G G U T S C C C S G C T C X f U X X C U C S B 
B U G G T G G U f G U S S f T C U C T T G C T G S U C U U B 
B C S U U S T C T C S X U T f C f C X U C X C S f X f C T B 
B G f U G C T C X C X f f S G G f C C G C f X S G S S X C B 
B X G C f T S G X S G X T T T f G G U X G X f U X X U T T B 
B C T G G X C S X f f X C T T X C f G U f U f U C C T C S B 
B X f U G C U G T G G f T G f T U S C G C G G U f X X f f B 
B G f X f U C T S S U S C G S f f C T C X f G U X X f G S B 
B G T X C C T f U C U S C S C U S G U G f T T T C X T G T B 
B U T U f G f C T S X G G T T f S G U C X f U U U C G G U B 
B B B B B B B B B B B B B B B B B B B B B B B B B B B B B B 
