B   B   B   B   B   B   B   B   B   B   B   B   B   B   B   B   B   B   B   B   B   B   B   B   B   B   B   B   B   B 
B   f   f   f   f   f   f   f   f   f   f   f   f   f   f   f   f   f   f   f   f   f   f   f   f   f   f   f   f   B 
B   J   f   f   f   f   f   f   f   f   f   f   f   f   f   f   f   f   f   f   f   f   f   f   f   f   f   f   f   B 
B   G   X   f   X   f   f   X   f   X   f   f   G   f   X   f   f   X   X   X   X   G   X   X   f   X   X   X   G   B 
B   f   X   f   f   G   f   f   f   f   f   G   f   X   G   X   X   X   f   G   X   G   X   f   X   f   X   f   f   B 
B   f   X   f   f   G   f   f   f   X   G   X   G   X   G   G   f   f   G   f   f   f   f   f   G   f   f   X   f   B 
B   X   G   G   f   f   G   f   X   G   G   f   f   G   X   X   X   G   X   X   f   X   f   G   f   X   G   X   f   B 
B   G   f   f   X   f   f   G   X   G   f   f   G   G   G   f   X   f   X   G   f   f   X   f   G   G   f   X   G   B 
B   X   X   G   X   G   G   X   G   f   f   f   f   f   G   f   G   G   f   f   f   X   f   G   G   X   G   f   G   B 
B   G   G   G   G   X   G   G   f   X   X   f   G   X   G   f   X   f   f   X   G   G   f   X   f   f   f   f   G   B 
B   G   G   f   G   f   X   G   f   f   G   G   G   X   G   f   f   f   G   G   G   X   f   G   X   f   f   f   X   B 
B   X   G   f   X   f   G   f   G   f   X   f   X   f   X   G   X   X   X   f   X   X   G   X   G   f   f   f   G   B 
B   G   X   f   X   G   G   X   f   X   G   G   X   G   f   f   X   f   X   f   f   f   X   G   G   G   G   X   G   B 
B   G   X   X   f   f   G   G   X   X   f   G   X   X   X   f   X   G   X   f   G   X   f   X   f   f   X   X   X   B 
B   f   f   f   X   X   G   f   G   G   G   f   f   f   X   G   G   G   G   f   f   G   f   X   G   X   X   f   f   B 
B   G   G   f   f   f   G   X   X   G   G   G   f   X   f   G   f   X   f   G   f   f   X   G   G   X   X   f   G   B 
B   G   X   f   G   G   f   G   X   f   X   X   X   f   G   G   G   f   G   f   f   X   f   f   f   X   G   f   X   B 
B   X   X   f   G   G   f   f   X   G   f   f   X   f   X   G   X   X   X   G   f   X   G   X   X   f   X   G   f   B 
B   f   f   f   X   X   f   X   G   G   X   f   G   G   G   G   X   f   f   G   G   G   G   X   f   f   X   G   X   B 
B   B   B   B   B   B   B   B   B   B   B   B   B   B   B   B   B   B   B   B   B   B   B   B   B   B   B   B   B   B 
